w	w	w	w	w	w	w	w	w	w	w	w
w	t	t									w
w											w
w								b			w
w											w
w											w
w				w				b			w
w		p		w							w
w				w	w	w	w	w	w	w	w
w				w	w	w	w	w	w	w	w
w	w	w	w	w	w	w	w	w	w	w	w
