wwwwwwww
w      w
w  b   w
w      w
w  p   w
w   t  w
w      w
wwwwwwww