w,w,w,w,w,w,w,w,w,w,w,w
w,,,,,,,,w,,,w
w,,,,,,,,w,,,w
w,,b,,,,,,w,,,w
w,,,,,,,,w,t,,w
w,,,,,p,,,,,,w
w,,,,,,,,,,,w
w,,,,,,,b,w,t,,w
w,,,,,,,,w,,,w
w,,,,,,,,w,,,w
w,w,w,w,w,w,w,w,w,w,w,w